########
##  ####
##     #
##o.. .#
#  ##p##
# oo  ##
#     ##
########